################################################################
#..................#..................#...........#.....#......#
#..................#..................#...........#.....#......#
#..................#..................#...........#.....#......#
#..................%..................#.......x...#.....#......#
#..................%.............x....#...........#.....#......#
#..................#..................#...........#.....#......#
#..................#..................#......######.....#......#
#..................#.....##############...........#.....#......#
#..................#..................#...........#.....#......#
#..................#....          ....#...........#.....#......#
#..................#..................#...........#.....#......#
#..................#..................#.      ....#.....#......#
#..................#.           ......#...........#.....#......#
#..................#..................#...........#.....#......#
#..................#..................#...........#.....#......#
#..................#..................#...........#.....#......#
#% ##              #..................#...........#.....#......#
#..................#.....         ....#...........#.....#......#
#..................#..................#...........#.....%......#
#..................#..................#...........#.....%......#
#......x...........#..................#.######## .#.....%......#
#..................#..................#...........#.....%......#
#..................#..................#...........#.....%......#
#......      ......#..................#...........#.....%......#
#..................#..................#...........#.....#......#
#..................#......         ...#...........#.....#......#
#..................#..................#...........#.....#......#
##############... .#...            ...#...........#.....#......#
#................ .#..................#...........#.....#......#
#......   .........#..................#...........#.....#......#
#..................#..................#...........#.....#......#
#............  ....#..................#.....   ...#.....#......#
#..................#.....           ..#...........#.....#......#
#..................#..................#...........#.....#......#
#..................#..................#...........#.....#......#
#..................#..................#...........#######......#
##########%#########................................#..........#
#..................#......       ...................#..........#
#..................#......       ...................#..........#
#..................#......       ...................#..........#
###############....#......       ...................#..........#
#..................#................................#..........#
#..................#..........            .....................#
#....... ..........#...........................................#
#..................####################......###########.......#
#..................#..................#................#.......#
#..................#..................#................#.......#
#..................#..................#................#.......#
#.......############..... ............#................#.......#
#.............#.................... ...................#.......#
#.............#........................................#.......#
#.............#......###################################.%%%%%.#
#..... .......#......#.....................#...................#
#.............#......#.....................#...................#
#.............#......#.....................#...................#
#.............#......#.....................#...................#
###########...#......#.....................#...................#
#....................#.....................#...................#
#........ .... ......#..................... ...................#
#............. ......#......@..................................#
#....................#.........................................#
#....................#.........................................#
################################################################