################################################################
#..................#.................. ...........#.....#......#
#..................#.................. ...........#   ..#......#
#..................#.................. ...........%.... #......#
#.......x..........%     ............. .......x...#   ..#......#
#..................%     ........x.... ...........#.....#......#
#..................#.................. ...........#.....#......#
#....##########....#.................. ......######.....#......#
#..................#.....##############...........#.....#......#
#..................#..................#...........#####.#......#
#..................#....          ....#...........#.....#......#
#..................#..................#...........#.....#      #
#.....          ...#..................#.      ....#.....#......#
#..................#.           ......#...........#.....#......#
#..................#..................#...........#.....#......#
#..................#..................#...........#.....#......#
#..................#..................#...........#.....#......#
#% ##              #..................#...........#.....#......#
#..................#.....         ....#...........#.....#......#
#..................#..................#...........#.....%......#
#..................#..................#...........#     %......#
#....         .....#..................#.######## .#.....%......#
#..................#..................#...........#.....%......#
#..................#..................#.................%......#
#......      ......#..................#.................%......#
#..................#..................#.................#......#
#..................#......         ...#.................#......#
#..................#..................#.................#......#
##############... .#...            ...#.................#......#
#................ .#..................#...........#.....#......#
#......   .........#..................#...........#.....#......#
#..................#..................#...........#.....#......#
#............  ....#..................#.....   ...#.....#......#
#..................#.....           ..#...........#.....#......#
#..................#..................#...........#.....#......#
#..................#..................#...........#.....#......#
#..................#..................#...........#######......#
##########%%%%%%####................................#..........#
#..................#......       .....            ..#..........#
#..................#......       ...................#..........#
#..................#......       ...................#..........#
###############...........       ...................#..........#
#...................................................#..........#
#.............................            .....................#
#....... ......................................................#
#..................####################......###########.......#
#..................#..................#................#.......#
#...          .....#..................#................#.......#
#..................#..................#................#.......#
#.......############..... ............#................#.......#
#.............#.................... ...................#.......#
#.............#........................................#.......#
#.............#......#   %%%%%     #####################.%%%%%.#
#..... ..............#.....................#...................#
#....................#.....................#....           ....#
#....................#.....................#....           ....#
#.............#......#.....................#....           ....#
###########...#......#.....#############%%%#...................#
#....................#.....................#...................#
#........ .... ......#..................... ....          .....#
#............. ...... ......@...................          .....#
#.................... .........................................#
#.................... .........................................#
################################################################